3 4 3 2 2 2 3 4 3
2 1 2 1 3 1 2 1 2
0 0 0 1 1 1 0 0 0 
2 1 2 1 3 1 2 1 2
3 4 3 2 2 2 3 4 3